1111111
100CP01
1000E01
1111111