111111111111111111111
1E0000C00000C00000001
100000010100100010101
100101000100100010101
1P0C000000000000000C1
100000000000000000001
100001000000000000001
1000C1000000000000001
101111000000000000001
100000E00000000000001
10000000000C000000001
111111111111111111111